.,.,.,.,.,.,.,.,bat,.,.,.
.,.,.,.,.,.,.,.,.,.,.,.
.,.,.,bat,.,.,.,.,.,.,.,.
bat,.,.,.,.,.,.,.,.,.,.,.
.,.,.,bat,.,.,.,.,.,.,.,.
.,bat,.,.,.,.,.,.,.,.,.,.
.,.,.,.,.,.,.,.,bat,.,.,.
